Canton,PLR,UDC,Le Centre,PS,Total
ZH,14,2,0,4,20
VD,14,1,0,0,15
BE,6,7,0,1,14
NE,6,0,0,3,9
TI,4,0,4,0,8
SG,4,0,2,0,6
SO,4,0,0,2,6
AG,4,0,1,0,5
GE,3,0,0,2,5
LU,2,0,3,0,5
FR,0,0,3,1,4
VS,1,0,3,0,4
GR,2,2,0,0,4
TG,3,0,0,0,3
AI,0,0,2,0,2
AR,2,0,0,0,2
ZG,0,0,2,0,2
BS,1,0,0,1,2
BL,1,0,0,0,1
GL,1,0,0,0,1
JU,1,0,0,0,1
OW,0,0,1,0,1
